3 0 1 1 1 1 1 1 1 1 5 5 5 5 5 5 5 5 5 5
0 0 0 1 1 1 1 1 1 1 1 1 1 1 1 1 5 5 5 5
1 0 0 0 1 1 1 1 1 1 1 1 1 1 0 0 0 5 5 5
1 1 0 0 0 1 1 1 1 1 1 1 1 1 0 2 0 1 1 5
1 1 1 0 0 0 0 0 0 4 0 0 1 1 0 1 1 1 1 5
1 1 1 1 0 0 0 0 0 0 0 0 0 1 0 1 1 1 1 5
1 1 1 1 1 1 0 1 1 1 1 0 0 0 0 1 1 1 1 1
2 1 1 1 1 1 0 1 1 1 1 1 4 0 0 0 1 1 1 1
2 2 1 1 1 1 0 1 1 5 5 1 1 1 0 0 0 1 1 1
2 2 1 1 1 1 0 1 1 5 5 1 1 1 1 0 0 1 1 1
2 1 1 1 1 1 0 1 1 1 1 1 1 1 1 0 0 1 1 1
1 1 1 1 0 0 0 0 0 0 0 4 0 0 0 0 0 1 1 1
1 1 1 1 4 0 0 0 0 0 0 0 0 0 0 0 0 1 1 1
1 1 1 1 0 0 1 1 1 1 1 1 1 1 1 1 1 1 1 1
1 1 1 1 6 6 1 1 1 1 1 1 1 1 1 1 1 1 1 1