1 1 1 1 1 1 1 1 0 3 0 1 1 1 1 1 1 1 1 1
1 1 1 1 1 1 1 1 0 0 0 1 1 1 1 1 1 1 1 1
1 1 1 2 2 1 1 1 0 0 0 1 1 1 1 1 1 1 1 1
1 1 2 2 2 1 1 1 1 0 0 0 0 4 0 0 0 1 2 2
1 1 1 1 2 1 1 1 1 0 1 1 1 1 1 1 0 1 2 5
1 1 1 1 1 1 1 1 1 4 1 1 1 1 1 1 0 2 5 5
1 1 1 1 1 1 1 1 1 0 1 1 1 1 1 1 0 0 5 5
1 0 0 0 1 1 1 1 1 0 1 1 1 1 1 1 1 2 5 5
1 0 1 0 1 1 1 1 1 0 1 1 1 1 1 1 1 2 2 5
1 0 1 0 0 1 1 1 0 0 0 0 1 1 1 1 1 1 2 5
1 0 1 1 0 0 0 0 0 2 2 0 0 0 0 0 0 1 2 5
1 0 1 1 1 1 1 1 0 2 2 0 1 1 1 1 0 1 2 5
1 0 1 1 1 1 1 1 0 0 0 0 1 0 0 0 0 1 2 5
1 0 1 1 1 1 1 1 1 1 0 1 1 0 1 1 1 1 2 5
1 0 1 1 1 1 1 1 1 1 4 1 1 0 1 1 1 1 2 5
6 0 1 1 1 1 1 1 1 1 0 1 1 4 1 1 1 1 2 5
6 0 0 0 0 4 0 0 0 0 0 1 0 0 1 1 1 1 5 5
6 1 1 0 1 1 1 1 1 1 1 1 0 1 1 1 1 5 5 5
1 1 1 0 1 1 0 0 0 0 0 0 0 1 1 5 5 5 5 5
1 1 1 0 0 0 0 1 1 1 1 1 1 1 5 5 5 5 5 5
1 1 1 1 1 1 1 1 1 1 1 5 5 5 5 5 5 5 5 5